also remove image=ta också bort image
Apply=Tillämpa
Are you sure=Är du säker?
Cancel=Avbryt
checking=kontrollerar
Completely REMOVE=Ta bort helt
Console=Console
day=dag
days=dagar
disk image and definition=
Disks=Diskar
Done=Klar
Edit=Redigera
Execution error=
Force Stop=Tvinga stopp
Hibernate=
Log for=Log for:
log=log
Logs=Loggar
More Info=Mer information
No=Nej
OK=OK
Ok=Ok
Pause=Pausa
Proceed=Fortsätt
Project Page=Projektsida
Remove container=Ta bort behållare
Remove definition=Ta bort definition
Remove image=Ta bort image
Remove VM=Ta bort VM
Remove=Ta bort
Restart=Starta om
Resume=Fortsätt
Start=Starta
Stop=Stopp
Support=Support
Update container=Uppdatera behållare
Update=Uppdatera
Updating all Containers=Uppdatera alla behållare
Updating the container=Uppdaterar behållarna
VNC Remote=VNC
WebUI=Webgränssnitt
Yes, delete it=Ja, radera!
Yes, update it=Ja, uppdatera!
Yes=Ja

; footer messages
Array Starting=Array startar
Array Stopping=Array stoppar
Mounting disks=
Spinning up all drives=
Starting services=Startar tjänster
Stopping services=Stoppar tjänster
Unmounting disks=
